111111111111111111111111111111
100C0E000000000000000000P10001
101100000111111111111000011111
110000000000000A00000000000011
110111111111111111111111111011
100000000000000000000000000001
111110000111111111111000011111
100100000001000000000000000001
100100001001000000000000000001
100000001000000000000000000001
100000001000000000000000000001
100000001000000000000000000001
100000001000000000000000000001
100000001000000000000000000001
100000001000000000000000000001
111111111111111111111111111111