111111111111111111111111
10110C100000C10C000000P1
101101101000111111101001
1EAC00001000100000001001
101000000010010C11111001
1C11000010C0000000000001
111111111111111111111111