1111111111111111111111
1ECCCCCCCCCCCCCCCCCCP1
1CACCCCCCCCCCCCCCCCCC1
1CCCCCCCCCCCCCCCCCCC11
1111111111111111111111