111111111
1PCCCCCC1
1CCCCCEC1
111111111