111111111111111111111111111111111111111111111111111111111111111111111111111111111111111111111111111111
1P0000000001000000000000000000111000000000000001110000000001000000000000000000111000000000000001111111
100000000001000000000000000000111000000000000001110000000001000000000000000000111000000000000001111111
100000000001000000000000000000111000000000000001110000000001000000000000000000111000000000000001111111
100000000001000000000000000000111000000000000001110000000001000000000000000000111000000000000001111111
100000000001000000000000000000111000000000000001110000000001000000000000000000111000000000000001111111
100000000001000000000000000000111000000000000001110000000001000000000000000000111000000000000001111111
100000000001000000000000000000111000000000000001110000000001000000000000000000111000000000000001111111
100000000001000000000000000000111000000000000001110000000001000000000000000000111000000000000001111111
100000000001000000000000000000111000000000000001110000000001000000000000000000111000000000000001111111
111C000000000010000000000000000000001000000000000001C0000000000100000000000000000000010000000000000011
1C110000000111111100000111111111110000000C0000000011C110000000111111100000111111111110000000C000000001
10000000000000000000E0000000000000000000000000000011C110000000111111100000111111111110000000C000000001
111111111111111111111111111111111111111111111111111111111111111111111111111111111111111111111111111111