111111111111111111111111111111
1P0000C00000E00000000000000001
100100001000100000000000000001
100100001000100000000C00000001
100100000010000000000000000001
100100001000100000000C00000001
111111111111111111111111111111