1111111111111
1P0C00C000001
100000C000111
1000000000E01
1111111111111